#,#,#,#,#,#,#
#,S, , , , ,#
#,#,#,#, ,#,#
#, , , , , ,#
#, ,#,#,#,#,#
#, , , ,G, ,#
#,#,#,#,#,#,#