#,#,#,#,#,#,#
#,S, , , , ,#
#,#,#,#, ,#,#
#, , , , , ,#
#, ,#,#,#, ,#
#, , , ,G, ,#
#,#,#,#,#,#,#